############## ##
#  #            #
#  #  # ### # ###
#  #  # #   #  ##
#     #   #### ##
### #############