############## ##
#  #            #
#  #  # ### # ###
#  #  #     #  ##
#     #   #### ##
### #############