# ###############
#  #            #
#  #  # ### # ###
#  #  #     #   #
#     #   ####  #
############## ##